[
-                                                                                                       -|
-                                                                                                       -|
-                                                                                                       -|
-                                                                                                       -|
-                                                                                                       -|
-                                                         ----------                                    -|
-    --------                ---------------------                         --   --   --    --           -|
-                                                                                                       -|
-                   ----                                                                            -----|
-                                                                                                       -|
-                                                                                                       -|
-                                                         ------                           ---          -|
-                                                              -                                        -|
- !                                             ---            -                                        -|
-==============                                                -                                    -----|
---------------===                                             -                                        -|
------------------===        3             ==++++++++++++++++++-                   3                    -|
---------------------======================--==================-========================================-|
---------------------------------------------------------------------------------------------------------|
---------------------------------------------------------------------------------------------------------|
---------------------------------------------------------------------------------------------------------|
-                                                                                                       -|
-                                                                                                       -|
-                                                                                                       -|
-                                                                                                       -|
-                                                                                                       -|
-                                                                                                       -|
-                   ----                ----                                                            -|
-                            -----                                                                      -|
-      --------                                                                                         -|
-                                                  ----                                                 -|
-                                                                                                       -|
-                                                                                                       -|
------------------                                                                                      -|
------------------------+++++++++++++++++++++++++++++++++            +++         +++                    -|
---------------------------------------------------------------------------------------------------------|
]
/


